1111111
1P000P1
1000001
1C000E1
1111111