11111111
1E000001
100P0001
10000001
1C000C01
11111111
