111111
1P00C1
1E0001
1C0021
111111