111111
1P00C1
1E1111
1C0001
111111
