111111
1P00C1
1E0001
1C0001
111111